NO ./textures/map/wall_1.xpm
SO ./textures/map/wall_2.xpm
WE ./textures/map/wall_3.xpm
EA ./textures/map/wall_4.xpm

F 51,204,51
C 0,102,255

        1111111111111111111111111
        1000000000110000000000001
        1011000001110000000000001
        1001000000000000000000001
111111111011000001100000000000001
100000000011000000110111111111111
11110111111111011100000010001
11110111111111011101010010001
110000001101010111000000100011
100000000000000011000000100001
100000000000000000010100000011
11000001110101011111000000N011
11110111 1110101 1011110000011
11111111 1111111 111111111111
