NO ./no_text
SO ./so_text
WE ./we_text
EA ./ea_text
F 220,100,0
C 230,30,0

1 11   11111
111111111111
1011N11101
111110111101
1111 1111111